0-0-0-0-0-0-0-0-0-0-0-0-0-0-0-0-0-0-0-0-0-0-0-0-0
0-0-0-0-12-12-12-0-0-12-12-12-0-0-12-12-12-0-0-12-12-12-0-0-0
0-0-0-0-12-15-12-0-0-12-15-12-0-0-12-15-12-0-0-12-15-12-0-0-0
0-0-0-0-12-12-12-0-0-12-12-12-0-0-12-12-12-0-0-12-12-12-0-0-0
0-0-0-0-0-0-0-0-0-0-0-0-0-0-0-0-0-0-0-0-0-0-0-0-0
0-0-0-0-0-0-0-0-0-0-0-0-0-0-0-0-0-0-0-0-0-0-0-0-0
0-0-0-12-12-12-0-0-12-12-12-0-0-12-12-12-0-0-12-12-12-0-0-0-0
0-0-0-12-15-12-0-0-12-15-12-0-0-12-15-12-0-0-12-15-12-0-0-0-0
0-0-0-12-12-12-0-0-12-12-12-0-0-12-12-12-0-0-12-12-12-0-0-0-0
0-0-0-0-0-0-0-0-0-0-0-0-0-0-0-0-0-0-0-0-0-0-0-0-0